sample_A	/data/darking1/projects/mito/Heteroplasmy/MitoHPC2/examples/Sim/ONT/bams//sample_A.bam	/data/darking1/projects/mito/Heteroplasmy/MitoHPC2/examples/Sim/ONT/out//sample_A/sample_A
sample_B	/data/darking1/projects/mito/Heteroplasmy/MitoHPC2/examples/Sim/ONT/bams//sample_B.bam	/data/darking1/projects/mito/Heteroplasmy/MitoHPC2/examples/Sim/ONT/out//sample_B/sample_B
sample_C	/data/darking1/projects/mito/Heteroplasmy/MitoHPC2/examples/Sim/ONT/bams//sample_C.bam	/data/darking1/projects/mito/Heteroplasmy/MitoHPC2/examples/Sim/ONT/out//sample_C/sample_C
sample_D	/data/darking1/projects/mito/Heteroplasmy/MitoHPC2/examples/Sim/ONT/bams//sample_D.bam	/data/darking1/projects/mito/Heteroplasmy/MitoHPC2/examples/Sim/ONT/out//sample_D/sample_D
sample_E	/data/darking1/projects/mito/Heteroplasmy/MitoHPC2/examples/Sim/ONT/bams//sample_E.bam	/data/darking1/projects/mito/Heteroplasmy/MitoHPC2/examples/Sim/ONT/out//sample_E/sample_E
sample_F	/data/darking1/projects/mito/Heteroplasmy/MitoHPC2/examples/Sim/ONT/bams//sample_F.bam	/data/darking1/projects/mito/Heteroplasmy/MitoHPC2/examples/Sim/ONT/out//sample_F/sample_F
sample_G	/data/darking1/projects/mito/Heteroplasmy/MitoHPC2/examples/Sim/ONT/bams//sample_G.bam	/data/darking1/projects/mito/Heteroplasmy/MitoHPC2/examples/Sim/ONT/out//sample_G/sample_G
sample_HV	/data/darking1/projects/mito/Heteroplasmy/MitoHPC2/examples/Sim/ONT/bams//sample_HV.bam	/data/darking1/projects/mito/Heteroplasmy/MitoHPC2/examples/Sim/ONT/out//sample_HV/sample_HV
sample_H	/data/darking1/projects/mito/Heteroplasmy/MitoHPC2/examples/Sim/ONT/bams//sample_H.bam	/data/darking1/projects/mito/Heteroplasmy/MitoHPC2/examples/Sim/ONT/out//sample_H/sample_H
sample_I	/data/darking1/projects/mito/Heteroplasmy/MitoHPC2/examples/Sim/ONT/bams//sample_I.bam	/data/darking1/projects/mito/Heteroplasmy/MitoHPC2/examples/Sim/ONT/out//sample_I/sample_I
sample_J	/data/darking1/projects/mito/Heteroplasmy/MitoHPC2/examples/Sim/ONT/bams//sample_J.bam	/data/darking1/projects/mito/Heteroplasmy/MitoHPC2/examples/Sim/ONT/out//sample_J/sample_J
sample_K	/data/darking1/projects/mito/Heteroplasmy/MitoHPC2/examples/Sim/ONT/bams//sample_K.bam	/data/darking1/projects/mito/Heteroplasmy/MitoHPC2/examples/Sim/ONT/out//sample_K/sample_K
sample_L0	/data/darking1/projects/mito/Heteroplasmy/MitoHPC2/examples/Sim/ONT/bams//sample_L0.bam	/data/darking1/projects/mito/Heteroplasmy/MitoHPC2/examples/Sim/ONT/out//sample_L0/sample_L0
sample_L1	/data/darking1/projects/mito/Heteroplasmy/MitoHPC2/examples/Sim/ONT/bams//sample_L1.bam	/data/darking1/projects/mito/Heteroplasmy/MitoHPC2/examples/Sim/ONT/out//sample_L1/sample_L1
sample_L2	/data/darking1/projects/mito/Heteroplasmy/MitoHPC2/examples/Sim/ONT/bams//sample_L2.bam	/data/darking1/projects/mito/Heteroplasmy/MitoHPC2/examples/Sim/ONT/out//sample_L2/sample_L2
sample_L3	/data/darking1/projects/mito/Heteroplasmy/MitoHPC2/examples/Sim/ONT/bams//sample_L3.bam	/data/darking1/projects/mito/Heteroplasmy/MitoHPC2/examples/Sim/ONT/out//sample_L3/sample_L3
sample_L4	/data/darking1/projects/mito/Heteroplasmy/MitoHPC2/examples/Sim/ONT/bams//sample_L4.bam	/data/darking1/projects/mito/Heteroplasmy/MitoHPC2/examples/Sim/ONT/out//sample_L4/sample_L4
sample_L5	/data/darking1/projects/mito/Heteroplasmy/MitoHPC2/examples/Sim/ONT/bams//sample_L5.bam	/data/darking1/projects/mito/Heteroplasmy/MitoHPC2/examples/Sim/ONT/out//sample_L5/sample_L5
sample_M	/data/darking1/projects/mito/Heteroplasmy/MitoHPC2/examples/Sim/ONT/bams//sample_M.bam	/data/darking1/projects/mito/Heteroplasmy/MitoHPC2/examples/Sim/ONT/out//sample_M/sample_M
sample_N	/data/darking1/projects/mito/Heteroplasmy/MitoHPC2/examples/Sim/ONT/bams//sample_N.bam	/data/darking1/projects/mito/Heteroplasmy/MitoHPC2/examples/Sim/ONT/out//sample_N/sample_N
sample_P	/data/darking1/projects/mito/Heteroplasmy/MitoHPC2/examples/Sim/ONT/bams//sample_P.bam	/data/darking1/projects/mito/Heteroplasmy/MitoHPC2/examples/Sim/ONT/out//sample_P/sample_P
sample_R	/data/darking1/projects/mito/Heteroplasmy/MitoHPC2/examples/Sim/ONT/bams//sample_R.bam	/data/darking1/projects/mito/Heteroplasmy/MitoHPC2/examples/Sim/ONT/out//sample_R/sample_R
sample_S	/data/darking1/projects/mito/Heteroplasmy/MitoHPC2/examples/Sim/ONT/bams//sample_S.bam	/data/darking1/projects/mito/Heteroplasmy/MitoHPC2/examples/Sim/ONT/out//sample_S/sample_S
sample_T	/data/darking1/projects/mito/Heteroplasmy/MitoHPC2/examples/Sim/ONT/bams//sample_T.bam	/data/darking1/projects/mito/Heteroplasmy/MitoHPC2/examples/Sim/ONT/out//sample_T/sample_T
sample_U	/data/darking1/projects/mito/Heteroplasmy/MitoHPC2/examples/Sim/ONT/bams//sample_U.bam	/data/darking1/projects/mito/Heteroplasmy/MitoHPC2/examples/Sim/ONT/out//sample_U/sample_U
sample_V	/data/darking1/projects/mito/Heteroplasmy/MitoHPC2/examples/Sim/ONT/bams//sample_V.bam	/data/darking1/projects/mito/Heteroplasmy/MitoHPC2/examples/Sim/ONT/out//sample_V/sample_V
sample_W	/data/darking1/projects/mito/Heteroplasmy/MitoHPC2/examples/Sim/ONT/bams//sample_W.bam	/data/darking1/projects/mito/Heteroplasmy/MitoHPC2/examples/Sim/ONT/out//sample_W/sample_W
sample_X	/data/darking1/projects/mito/Heteroplasmy/MitoHPC2/examples/Sim/ONT/bams//sample_X.bam	/data/darking1/projects/mito/Heteroplasmy/MitoHPC2/examples/Sim/ONT/out//sample_X/sample_X
sample_Y	/data/darking1/projects/mito/Heteroplasmy/MitoHPC2/examples/Sim/ONT/bams//sample_Y.bam	/data/darking1/projects/mito/Heteroplasmy/MitoHPC2/examples/Sim/ONT/out//sample_Y/sample_Y
sample_Z	/data/darking1/projects/mito/Heteroplasmy/MitoHPC2/examples/Sim/ONT/bams//sample_Z.bam	/data/darking1/projects/mito/Heteroplasmy/MitoHPC2/examples/Sim/ONT/out//sample_Z/sample_Z
